@midnight	At Midnight
A Certain Scientific Accelerator	Toaru Kagaku no Accelerator
Astra Lost in Space	Kanata no Astra
Australian Survivor	Survivor AU
Battlestar Galactica (2003)	BSG
Bordertown (2016)	Bordertown (US)
Catch-22	Catch 22
Cosmos: A Spacetime Odyssey	Cosmos A Space Time Odyssey
CSI: Crime Scene Investigation	CSI
Dragon Ball Z	DBZ
Fairy Tail	Fairy Tail Final Season
Fire Force	Enen no Shouboutai
Forever (2014)	Forever (US)
Game of Thrones	GOT
House of Cards	HOC
How I Met Your Mother	HIMYM
Instinct (2018)	Instinct (US)
Law & Order: Special Victims Unit	Law & Order SVU	Law and Order SVU
M*A*S*H	M.A.S.H.	MASH
Naruto Shippuden	Naruto Shippuuden
NCIS: Los Angeles	NCIS LA	NCIS LosAngeles
NCIS: New Orleans	Navy CIS New Orleans	NCIS NO
Once Upon a Time (2011)	OUaT
Outsiders	Outsiders (2016)
Proof (2015)	Proof (US)
Rapunzel's Tangled Adventure	Tangled: The Series
Resurrection	Resurrection (US)
Scream	Scream The TV Series
Sex&Drugs&Rock&Roll	Sex and Drugs and Rock and Roll
Smithsonian Channel Documentaries	Smithsonian
Star Trek	Star Trek: TOS
Star Trek: Deep Space Nine	Star Trek: DS9
Star Trek: Enterprise	Star Trek: ENT
Star Trek: The Next Generation	Star Trek: TNG
Star Trek: Voyager	Star Trek: VOY
Stargate SG-1	Stargate
Supergirl	Super Girl
The Big Bang Theory	TBBT
The Bridge (2013)	The Bridge (US)
The Code (2014)	The Code (AU)
The Inexplicable Universe	The Inexplicable Universe with Neil deGrasse Tyson
The Late Late Show with Craig Ferguson	Craig Ferguson
The Luxury Trap	Luksusfaelden
The Nightly Show with Larry Wilmore	The Nightly Show
The Walking Dead	TWD
UFC Primetime	UFC Fight Night
Warrior (2019)	Warrior
World Series of Poker	WSOP